1111111111
1P000E1011
1110000C01
1C00011111
1111111111