1111111111111111111111
1000000000000000000001
10000C0000000000000001
1000000000000000000001
1000000000001010000001
1000000011111010000001
10E0C000C0C0C0100P0001
1000000000000000000001
1000000000000000000001
1000000000000000C00001
1000000011111000000001
1000000000000000000001
1111111111111111111111